
d

dadadada

dadadada

z
111
11111111111111111


sdzdz
