
111111111111111
100E0001C000001
10000P000000001
111111111111111
