
111111111111111
100E0P01C000001
100000000000001
111111111111111
