
11111111111
100E0P01C01
10000000001
11111111111
