
111111111111111111111
100E0001C000001000C01
11000000000000000C001
100000P00000C11000C01
111111111111111111111

