
111111111111111111111
101E0001C000001000C01
11111000000000000C001
100000P00001C11000C01
111111111111111111111
