111111111111111111111111111111
1E00000C00000000000000C0000001
111111111100000000000011111111
1C1000100000C00100000001C001C1
100010001110000000010001010001
1111111011001000C0000001011111
1000000010000000111111110101C1
100000000000100000000001000001
100000C00000010000010001111001
10000001000000000000C000000001
100000000010000010000001000001
100000000000000000000010000001
1111111C0010001000001010000001
100000001010001000000000000001
10C1001000100C10000C01000000P1
111111111111111111111111111111