
111111111111111111111
101E0001C00000100AC01
111110A0000000000C001
100000P0A001C11000C01
111111111111111111111
